a	a	LEXID=pron	NO ADJUSTED INFL DATA: 
agasti	ag/asti	NO ADJUSTED INFL DATA: <lex type="inh">m. <ab>pl.</ab></lex>
agnAmarutO	agnA--marutO	INFLECTID=m1d
agnAvizRU	agnA--vizRU	INFLECTID=m1d
agnizvAtta	agn/i--zvAtt/a	NO ADJUSTED INFL DATA: <lex type="inh">m. <ab>pl.</ab></lex>
agnIndrO	agnI<srs/>ndr/O	INFLECTID=m1d
agnIparjanyO	agnI-parjanyO	INFLECTID=m1d
agnIvaruRO	agnI-v/aruRO	INFLECTID=m1d
agnIzomA	agnI-z/omA	INFLECTID=m1d
agnIzomO	agnI-z/omO	INFLECTID=m1d
aNgiras	/aNgiras	NO ADJUSTED INFL DATA: <lex type="inh">m. <ab>pl.</ab></lex>
aja	aj/a	NO ADJUSTED INFL DATA: <lex type="inh">m. <ab>pl.</ab></lex>
ajavasti	aj/a--vasti	NO ADJUSTED INFL DATA: <lex type="inh">m. <ab>pl.</ab></lex>
adas	ad/as	LEXID=pron
aDara	/aDara	LEXID=pron
antara	/antara	LEXID=pron
anya	any/a	LEXID=pron	NO ADJUSTED INFL DATA: 
anyatama	anya-tama	LEXID=pron
anyatara	anya-tar/a	LEXID=pron	NO ADJUSTED INFL DATA: 
apara	a-para	LEXID=pron
apiSala	apiSala	NO ADJUSTED INFL DATA: <lex type="inh">m. <ab>pl.</ab></lex>
abDijO	ab-Di--jO	INFLECTID=m1d
aBijidviSvajitO	aBijid-viSvaj/itO	INFLECTID=f1d
aBisAra	aBi-sAra	NO ADJUSTED INFL DATA: <lex type="inh">m. <ab>pl.</ab></lex>
amu	amu	LEXID=pron	NO ADJUSTED INFL DATA: 
ayam	ay/am	LEXID=pron	NO ADJUSTED INFL DATA: 
ayuta	a-y/uta	LEXID=card
arkajO	ark/a--jO	INFLECTID=m1d
arRAcitraraTA	/arRA-citr/araTA	INFLECTID=m1d
arTaSabdO	/arTa--SabdO	INFLECTID=m1d
arbuda	/arbuda	LEXID=card
alinda	alinda	NO ADJUSTED INFL DATA: <lex type="inh">m. <ab>pl.</ab></lex>
aloka	/a-loka	NO ADJUSTED INFL DATA: <lex type="inh">m. <ab>pl.</ab></lex>
avani	av/ani	NO ADJUSTED INFL DATA: <lex type="inh">f. <ab>pl.</ab></lex>
avaBfTayajUMzi	ava-BfT/a--yajUMzi	INFLECTID=n1p
avara	/avara	LEXID=pron
aSIti	aSIti	LEXID=card
aSmaka	aSmaka	NO ADJUSTED INFL DATA: <lex type="inh">m. <ab>pl.</ab></lex>
aSvaka	aSvak/a	NO ADJUSTED INFL DATA: <lex type="inh">m. <ab>pl.</ab></lex>
aSvatTa	aSvatTa	NO ADJUSTED INFL DATA: <lex type="inh">m. <ab>pl.</ab></lex>
aSvinIputrO	aSvinI-putrO	INFLECTID=m1d
aSvinIsutO	aSvinI-sutO	INFLECTID=m1d
azwan	azwan	LEXID=card	NO ADJUSTED INFL DATA: 
azwa	azwa	LEXID=card	NO ADJUSTED INFL DATA: 
azwacatvAriMSat	azwa--catvAriMSat	LEXID=card
azwanavati	azwa--navati	LEXID=card
azwapaYcASat	azwa--paYcASat	LEXID=card
azwazazwi	azwa--zazwi	LEXID=card
azwasaptati	azwa--saptati	LEXID=card
azwAcatvAriMSat	azw/A--catvAriMSat	LEXID=card
azwAtriMSat	azwA--triMSat	LEXID=card
azwAdaSan	azw/A--daSan	LEXID=card
azwAnavati	azwA--navati	LEXID=card
azwApaYcASat	azwA--paYcASat	LEXID=card
azwApruz	azwA--pruz	LEXID=card
azwAzazwi	azwA--zazwi	LEXID=card
azwAsaptati	azwA--saptati	LEXID=card
azwASIti	azwA<srs/>SIti	LEXID=card
asitamfga	/asita--mfga	NO ADJUSTED INFL DATA: <lex type="inh">m. <ab>pl.</ab></lex>
asu	/asu	NO ADJUSTED INFL DATA: <lex type="inh">m. <ab>pl.</ab></lex>
asfkpAta	asfk--pAta	NO ADJUSTED INFL DATA: <lex type="inh">m. <ab>pl.</ab></lex>
asma	asma	LEXID=pron	NO ADJUSTED INFL DATA: 
asmat	asmat	LEXID=pron	NO ADJUSTED INFL DATA: 
asmad	asmad	LEXID=pron	NO ADJUSTED INFL DATA: 
asmad	asmad	LEXID=pron	NO ADJUSTED INFL DATA: 
aham	ah/am	LEXID=pron	NO ADJUSTED INFL DATA: 
ahirbuDnya	ahir-buDnya	NO ADJUSTED INFL DATA: <lex type="inh">m. <ab>pl.</ab></lex>
Akarza	A-karza	NO ADJUSTED INFL DATA: <lex type="inh">m. <ab>pl.</ab></lex>
AjihIna	Aj/i--hIna	NO ADJUSTED INFL DATA: <lex type="inh">m. <ab>pl.</ab></lex>
Ajyagraha	/Ajya--graha	NO ADJUSTED INFL DATA: <lex type="inh">m. <ab>pl.</ab></lex>
AtmapravAda	Atma--pravAda	NO ADJUSTED INFL DATA: <lex type="inh">m. <ab>pl.</ab></lex>
Aditya	Adity/a	NO ADJUSTED INFL DATA: <lex type="inh">m. <ab>pl.</ab></lex>
AdityacandrO	Adity/a--candrO	INFLECTID=m1d
Anarta	A-narta	NO ADJUSTED INFL DATA: <lex type="inh">m. <ab>pl.</ab></lex>
Arava	A-rava	NO ADJUSTED INFL DATA: <lex type="inh">m. <ab>pl.</ab></lex>
ArjunAyana	ArjunAyana	NO ADJUSTED INFL DATA: <lex type="inh">m. <ab>pl.</ab></lex>
AryAvarta	AryA<srs/>varta	NO ADJUSTED INFL DATA: <lex type="inh">m. <ab>pl.</ab></lex>
Ava	Av/a	LEXID=pron	NO ADJUSTED INFL DATA: 
Ava	Av/a	LEXID=pron	NO ADJUSTED INFL DATA: 
Ava	Av/a	LEXID=pron	NO ADJUSTED INFL DATA: 
Ava	Av/a	LEXID=pron	NO ADJUSTED INFL DATA: 
AvaBftya	AvaBftya	NO ADJUSTED INFL DATA: <lex type="inh">m. <ab>pl.</ab></lex>
AsurAyaRa	AsurAyaR/a	NO ADJUSTED INFL DATA: <lex type="inh">m. <ab>pl.</ab></lex>
AsrAva	A-srAv/a	NO ADJUSTED INFL DATA: <lex type="inh">m. <ab>pl.</ab></lex>
Ahuka	Ahuka	NO ADJUSTED INFL DATA: <lex type="inh">m. <ab>pl.</ab></lex>
i	i	LEXID=pron	NO ADJUSTED INFL DATA: 
itara	/i-tara	LEXID=pron
idam	id/am	LEXID=pron	NO ADJUSTED INFL DATA: 
uqumbara	uqumb/ara	NO ADJUSTED INFL DATA: <lex type="inh">m. <ab>pl.</ab></lex>
utkala	ut-kala	NO ADJUSTED INFL DATA: <lex type="inh">m. <ab>pl.</ab></lex>
utkAsa	utkAsa	NO ADJUSTED INFL DATA: <lex type="inh">m. <ab>pl.</ab></lex>
utkzepO	ut-kzepO	INFLECTID=m1d
uttara	/uttara	LEXID=pron
uttara	/uttara	NO ADJUSTED INFL DATA: <lex type="inh">m. <ab>pl.</ab></lex>
uttarA	/uttarA	NO ADJUSTED INFL DATA: <lex type="inh">f. <ab>du.</ab></lex>
uttarA	/uttarA	NO ADJUSTED INFL DATA: <lex type="inh">f. <ab>pl.</ab></lex>
upapakzO	upa-pakz/O	INFLECTID=m1d
uparimeKala	upari--meKala	NO ADJUSTED INFL DATA: <lex type="inh">m. <ab>pl.</ab></lex>
upavAha	upa-vAha	NO ADJUSTED INFL DATA: <lex type="inh">m. <ab>pl.</ab></lex>
uBa	uB/a	LEXID=pron
uBaya	uB/aya	LEXID=pron
ulUka	/ulUka	NO ADJUSTED INFL DATA: <lex type="inh">m. <ab>pl.</ab></lex>
ulUta	ulUta	NO ADJUSTED INFL DATA: <lex type="inh">m. <ab>pl.</ab></lex>
uzRihA	uzR/ihA	NO ADJUSTED INFL DATA: <lex type="inh">f. <ab>pl.</ab></lex>
UrRanABa	UrRa--nABa	NO ADJUSTED INFL DATA: <lex type="inh">m. <ab>pl.</ab></lex>
ftaBAga	ft/a--BAga	NO ADJUSTED INFL DATA: <lex type="inh">m. <ab>pl.</ab></lex>
eka	/eka	LEXID=pron
ekacatvAriMSat	/eka--catvAriMSat	LEXID=card
ekadehO	/eka--dehO	INFLECTID=m1d
ekanavati	/eka--navati	LEXID=card
ekapaYcASat	/eka--paYcASat	LEXID=card
ekaviMSat	/eka--viMSat	LEXID=card
ekaviMSati	/eka--viMSati	LEXID=card
ekazazwi	/eka--zazwi	LEXID=card
ekasaptati	/eka--saptati	LEXID=card
ekANgO	ekA<srs/>NgO	INFLECTID=m1d
ekAdaSa	ekAdaS/a	LEXID=card
ekAdaSa	/ekAdaSa	LEXID=card	NO ADJUSTED INFL DATA: 
ekAdaSan	/ekAdaSan	LEXID=card
ekASIti	ekA<srs/>SIti	LEXID=card
ekEka	/ekE<srs1/>ka	LEXID=pron
ekonaviMSati	eko<srs/>na----viMSat/i	LEXID=card
etad	et/ad	LEXID=pron
etat	etat	LEXID=pron	NO ADJUSTED INFL DATA: 
etan	etan	LEXID=pron	NO ADJUSTED INFL DATA: 
ena	ena	LEXID=pron	NO ADJUSTED INFL DATA: 
eza	ez/a	LEXID=pron	NO ADJUSTED INFL DATA: 
OlUKalO	OlUKal/O	INFLECTID=m1d
ka	k/a	LEXID=pron	NO ADJUSTED INFL DATA: 
katama	katam/a	LEXID=pron
katara	katar/a	LEXID=pron
kanizWa	kanizW/a	NO ADJUSTED INFL DATA: <lex type="inh">m. <ab>pl.</ab></lex>
kalkuzI	kalkuz/I	INFLECTID=f/n1d
kAkutsTO	kAkutsTO	INFLECTID=m1d
kArtakOjapO	kArta-kOjapO	INFLECTID=m1d
kiM	kiM	LEXID=pron	NO ADJUSTED INFL DATA: 
kiM	kiM	LEXID=pron	NO ADJUSTED INFL DATA: 
kilAtAkulI	kilAtA<srs/>kul/I	INFLECTID=m1d
kumAra	kumAr/a	NO ADJUSTED INFL DATA: <lex type="inh">m. <ab>pl.</ab></lex>
kuru	k/uru	NO ADJUSTED INFL DATA: <lex type="inh">m. <ab>pl.</ab></lex>
kuru	k/uru	NO ADJUSTED INFL DATA: <lex type="inh">m. <ab>pl.</ab></lex>
kuSika	kuSik/a	NO ADJUSTED INFL DATA: <lex type="inh">m. <ab>pl.</ab></lex>
kuSIlavO	kuSIlavO	INFLECTID=m1d
kfcCrAtikfcCrO	kfcCrA<srs/>tikfcCrO	INFLECTID=m1d
kfzRO	kfzR/O	INFLECTID=m1d
kowi	kowi	LEXID=card	NO ADJUSTED INFL DATA: 
kratUdakzO	kr/atU-d/akzO	INFLECTID=m1d
kruYcO	kr/uYcO	INFLECTID=m1d
Karva	Karv/a	LEXID=card
KArdamAyana	KArdamAyana	NO ADJUSTED INFL DATA: <lex type="inh">m. <ab>pl.</ab></lex>
gaNgAyamune	g/aNgA--yamune	INFLECTID=f1d
guRavfdDI	guR/a--vfdDI	INFLECTID=f1d
gopAlakakza	g/o--pAl/a---kakza	NO ADJUSTED INFL DATA: <lex type="inh">m. <ab>pl.</ab></lex>
gOpAyana	gOpAyana	NO ADJUSTED INFL DATA: <lex type="inh">m. <ab>pl.</ab></lex>
grAma	gr/Ama	NO ADJUSTED INFL DATA: <lex type="inh">m. <ab>pl.</ab></lex>
catasf	c/atasf	LEXID=card
catuHzazwi	catuH--zazwi	LEXID=card
catuHsaptati	catuH--saptati	LEXID=card
catur	catur	LEXID=card
caturaSIti	catur--aSIti	LEXID=card
caturdaSan	catur--daSan	LEXID=card	NO ADJUSTED INFL DATA: 
caturnavati	catur--navati	LEXID=card
caturviMSat	catur--viMSat	LEXID=card
caturviMSati	c/atur--viMSati	LEXID=card
catuScatvAriMSat	catuS--catvAriMSat	LEXID=card
catustriMSat	catus--triMSat	LEXID=card
catvAriMSat	catvAriMS/at	LEXID=card
catvAriMSati	catvAriMSati	LEXID=card
cEtyaSEla	cEtya--SEla	NO ADJUSTED INFL DATA: <lex type="inh">m. <ab>pl.</ab></lex>
CAgavya	CAgavya	NO ADJUSTED INFL DATA: <lex type="inh">m. <ab>pl.</ab></lex>
jampatI	jam-patI	INFLECTID=m1d
jAyampatI	jAyam-patI	INFLECTID=m1d
jAyApatI	jAy/A--pat/I	INFLECTID=m1d
ta	t/a	LEXID=pron	NO ADJUSTED INFL DATA: 
tatama	t/a--tama	LEXID=pron
tatara	t/a--tara	LEXID=pron
tat	tat	LEXID=pron	NO ADJUSTED INFL DATA: 
tac	tac	LEXID=pron	NO ADJUSTED INFL DATA: 
tad	t/ad	LEXID=pron	NO ADJUSTED INFL DATA: 
tan	tan	LEXID=pron	NO ADJUSTED INFL DATA: 
tyad	ty/ad	LEXID=pron
tra	tra	LEXID=card	NO ADJUSTED INFL DATA: 
trayaHpaYcASat	trayaH--paYcASat	LEXID=card
trayaHzazwi	trayaH--zazwi	LEXID=card
trayaHsaptati	trayaH--saptati	LEXID=card
trayaScatvAriMSat	trayaS--catvAriMSat	LEXID=card
trayastriMSat	tr/ayas--triMSat	LEXID=card
trayastriMSati	tr/ayas--triMSati	LEXID=card
trayodaSa	tr/ayo--daSa	LEXID=card
trayonavati	trayo--navati	LEXID=card
trayoviMSati	tr/ayo--viMSati	LEXID=card
tri	tr/i	LEXID=card
trikadruka	tr/i--kadruka	NO ADJUSTED INFL DATA: <lex type="inh">m. <ab>pl.</ab></lex>
tricatvAriMSat	tr/i--catvAriMSat	LEXID=card
trinavati	tr/i--navati	LEXID=card
tripaYcASat	tr/i--paYcASat	LEXID=card
trizazwi	tr/i--zazwi	LEXID=card
trisaptati	tr/i--saptati	LEXID=card
triMSat	triMS/at	LEXID=card
triMSati	triMSati	LEXID=card
tryambaka	try--/ambaka	NO ADJUSTED INFL DATA: <lex type="inh">m. <ab>pl.</ab></lex>
tryaSIti	try--aSIti	LEXID=card
tva	tva	LEXID=pron
tva	tv/a	LEXID=pron	NO ADJUSTED INFL DATA: 
tva	tv/a	LEXID=pron
dakziRa	d/akziRa	LEXID=pron
daSa	daSa	LEXID=card
daSan	daSan	LEXID=card	NO ADJUSTED INFL DATA: 
divaspfTivyO	di<sr/>vas-pfTivyO	INFLECTID=f1d
dyAvAkzame	dy/AvA--kzame	INFLECTID=f1d
dyAvABUmI	dy/AvA--BUmI	INFLECTID=f1d
dyoBUmI	dyo--BUmI	INFLECTID=f1d
dva	dva	LEXID=card
dvAcatvAriMSat	dvA--catvAriM<sr1/>Sat	LEXID=card
dvAcatvAriMSati	dvA--catvAriM<sr1/>Sati	LEXID=card
dvAtriMSat	dv/A--triMSat	LEXID=card
dvAnavati	dvA--nava<sr1/>ti	LEXID=card
dvApaYcASat	dvA--paYcASat	LEXID=card
dvAviMSati	dvA--viMSati	LEXID=card
dvAzazwi	dvA--zazwi	LEXID=card
dvAsaptati	dv/A--saptati	LEXID=card
dvAdaSan	dv/A-daSan	LEXID=card	NO ADJUSTED INFL DATA: 
dvAdaSa	dv/A-daSa	LEXID=card	NO ADJUSTED INFL DATA: 
dvi	dvi	LEXID=pron	NO ADJUSTED INFL DATA: 
dvicatvAriMSat	dvi--catvAriMSat	LEXID=card
dvinavati	dvi--navati	LEXID=card
dvipaYcASat	dvi--paYcASat	LEXID=card
dvizazwi	dvi--zazwi	LEXID=card
dvisaptati	dvi--saptati	LEXID=card
dvyaSIti	dvy--aSIti	LEXID=card
navacatvAriMSat	n/ava--catvAriM<sr1/>Sat	LEXID=card
navanavati	n/ava--navati	LEXID=card
navapaYcASat	n/ava--paYcA<sr1/>Sat	LEXID=card
navazazwi	n/ava--zazwi	LEXID=card
navasaptati	n/ava--saptati	LEXID=card
navASIti	navA<srs/>SIti	LEXID=card
navati	navat/i	LEXID=card
navan	navan	LEXID=card	NO ADJUSTED INFL DATA: 
niKarva	ni-Karva	LEXID=card
nema	n/<srs/>ema	LEXID=pron
nema	n/e<srs/>ma	LEXID=pron	NO ADJUSTED INFL DATA: 
nezwApotArO	nezwA--potArO	INFLECTID=m1d
nezwodgAtArO	nezwo<srs/>dgAtArO	INFLECTID=m1d
nO	nO	LEXID=pron	NO ADJUSTED INFL DATA: 
paYca	paYca	LEXID=card	NO ADJUSTED INFL DATA: 
paYcacatvAriMSat	paYca--catvAriMSat	LEXID=card
paYcatriMSati	paYca--triMSati	LEXID=card
paYcadaSa	paYca--daSa	LEXID=card	NO ADJUSTED INFL DATA: 
paYcadaSan	paYca--daSan	LEXID=card
paYcanavati	paYca--navati	LEXID=card
paYcapaYcASat	paYca--paYcASat	LEXID=card
paYcaviMSat	paYca--viMSat	LEXID=card
paYcaviMSati	p/aYca--viMSati	LEXID=card
paYcazazwi	paYca--zazwi	LEXID=card
paYcasaptati	paYca--saptati	LEXID=card
paYcASIti	paYcA<srs/>SIti	LEXID=card
paYcan	p/aYcan	LEXID=card	NO ADJUSTED INFL DATA: 
paYcASat	paYcAS/at	LEXID=card
paYcASati	paYcASa<sr/>ti	LEXID=card
para	p/ara	LEXID=pron
pitf	pit/f	NO ADJUSTED INFL DATA: <lex type="inh">m. <ab>pl.</ab></lex>
pUrva	p/Urva	LEXID=pron
prayuta	pra-<sr/>y/uta	LEXID=card
Bavat	B/avat	LEXID=pron
Bavad	Bavad	LEXID=pron	NO ADJUSTED INFL DATA: 
Bavan	Bavan	LEXID=pron	NO ADJUSTED INFL DATA: 
ma	ma	LEXID=pron	NO ADJUSTED INFL DATA: 
ma	ma	LEXID=pron	NO ADJUSTED INFL DATA: 
ma	ma	LEXID=pron	NO ADJUSTED INFL DATA: 
maNga	maNga	NO ADJUSTED INFL DATA: <lex type="inh">m. <ab>pl.</ab></lex>
mat	m/at	LEXID=pron	NO ADJUSTED INFL DATA: 
mad	mad	LEXID=pron	NO ADJUSTED INFL DATA: 
mat	mat	LEXID=pron	NO ADJUSTED INFL DATA: 
man	man	LEXID=pron	NO ADJUSTED INFL DATA: 
mahArbuda	mah/A<srs/><sr1/>rbuda	LEXID=card
mAtarapitarO	mAtara-pitarO	INFLECTID=m1d
yatama	ya--tam/a	LEXID=pron
yatara	ya--tar/a	LEXID=pron
yad	y/ad	LEXID=pron	NO ADJUSTED INFL DATA: 
yac	yac	LEXID=pron	NO ADJUSTED INFL DATA: 
yat	yat	LEXID=pron	NO ADJUSTED INFL DATA: 
yan	yan	LEXID=pron	NO ADJUSTED INFL DATA: 
yuva	yuv/a	LEXID=pron	NO ADJUSTED INFL DATA: 
yuzmat	yuzmat	LEXID=pron	NO ADJUSTED INFL DATA: 
yuzmad	yuzmad	LEXID=pron	NO ADJUSTED INFL DATA: 
yuzmA	yuzmA	LEXID=pron	NO ADJUSTED INFL DATA: 
rAtryahanI	rAtry--ahanI	INFLECTID=n1d
lakza	lakz/a	LEXID=card
lambAviSvavayasO	lambA--viSvavayasO	INFLECTID=m1d
vayam	vay/am	LEXID=pron	NO ADJUSTED INFL DATA: 
vas	vas	LEXID=pron	NO ADJUSTED INFL DATA: 
vAm	vAm	LEXID=pron	NO ADJUSTED INFL DATA: 
viMSati	viMSat/i	LEXID=card
viMSat	viMSat	LEXID=card	NO ADJUSTED INFL DATA: 
viSva	v/iSva	LEXID=pron
Sata	Sat/a	LEXID=card
SaMtAti	S/aM--tAti	NO ADJUSTED INFL DATA: <lex type="inh">f. <ab>pl.</ab></lex>
SukrAmanTinO	Sukr/A-manT/inO	INFLECTID=m1d
zaz	z/az	LEXID=card
zawcatvAriMSat	zaw--catvAriMSat	LEXID=card
zawtriMSat	z/aw--triMSat	LEXID=card
zawtriMSati	zaw--triMSati	LEXID=card
zawpaYcASat	z/aw--paYcASat	LEXID=card
zawzazwi	zaw--zazwi	LEXID=card
zawsaptati	zaw--saptati	LEXID=card
zaqaSIti	zaq--aSIti	LEXID=card
zaqviMSat	zaq--viMSat	LEXID=card	NO ADJUSTED INFL DATA: 
zaqviMSati	z/aq--viMSati	LEXID=card
zaRRavati	z/aR-Ravati	LEXID=card
zazwi	zazw/i	LEXID=card
zoqaSa	zoqaSa	LEXID=card	NO ADJUSTED INFL DATA: 
zoqaSan	z/o-qaSan	LEXID=card
sa	s/a	LEXID=pron	NO ADJUSTED INFL DATA: 
saMyatI	saM-yatI	INFLECTID=n1d
saMtAnaka	saM<sr1/>-tAnaka	NO ADJUSTED INFL DATA: <lex type="inh">m. <ab>pl.</ab></lex>
saptan	sapt/an	LEXID=card	NO ADJUSTED INFL DATA: 
sapta	sapta	LEXID=card	NO ADJUSTED INFL DATA: 
saptacatvAriMSat	sapta--catvAriMSat	LEXID=card
saptatriMSat	sapta--triMSat	LEXID=card
saptatriMSati	sapta--triMSati	LEXID=card
saptadaSa	sapta--daS/a	LEXID=card	NO ADJUSTED INFL DATA: 
saptadaSan	sapt/a--daSan	LEXID=card
saptanavati	sapta--navati	LEXID=card
saptapaYcASat	sapta--paYcASat	LEXID=card
saptaviMSat	sapta--viMSat	LEXID=card	NO ADJUSTED INFL DATA: 
saptaviMSati	sapt/a--viMSati	LEXID=card
saptazazwi	sapta--zazwi	LEXID=card
saptASIti	saptA<srs/>SIti	LEXID=card
saptati	saptat/i	LEXID=card
sama	sama	LEXID=pron
sarva	s/arva	LEXID=pron
sahasra	sah/asra	LEXID=card
sArisTAKA	sArisTA-KA~	LOAN
sima	sim/a	LEXID=pron
sItormile	sIto<srs/>rmile	INFLECTID=f1d
sUryAgnI	sUryA<srs/>gn/I	INFLECTID=m1d
sUryAcandramasA	sUryA-candram/asA	INFLECTID=m1d
sUryAcandramasO	sUryA-candram/a<sr/>sO	INFLECTID=m1d
sUryAmAsA	s/UryA-m/AsA	INFLECTID=m1d
sevyasevakO	sevya--sevakO	INFLECTID=m1d
sOraBeya	s/OraBeya	NO ADJUSTED INFL DATA: <lex type="inh">m. <ab>pl.</ab></lex>
sva	sv/a	LEXID=pron
hotADvaryU	hotA<srs/>DvaryU	INFLECTID=m1d
hotApotArO	hotA-potArO	INFLECTID=m1d
